--#---##--#-
-#--#---##-#
####--#-#-##
--#----#-#--
-#-###----#-
--#-----#---
-#####-###-#
-----------@

