---#--###---
-#---#----##-
####-#-#-#-##
---#---#-#---
-#-####---##-
-#------#----
-#######-##--
------------@
